MAPSTART
XXXXXXXXXXXXXXXXXXXXX
X                   X
X    XX      X      X
X    X X     X      X
X    X  X    X      X
X    X   X   X      X
X    X    X  X      X
X    X     X X      X
X    X      XX      X
X                   X
XXXXXXXXXXDXXXXXXXXXX
MAPFINISH
ITEMS
Box of Goodies,6,5,1,3,6
MONSTERS
Green Ogre,5,3,2,6
ENDFILE