MAPSTART
XXXXXXXXXXXXXXXXXXXXX
X      X       X    X
X  XXXXX   X        X
X          X   X    X
XXXXXXXXXXXXXXXX XXXX
X   X          X    X
X   X   X      X    X
X   X   X      X    X
X   X   X      X    X
X       X           X
XXXXXXXXXXXXXXXXXXXXX
MAPFINISH
ITEMS
Healing Potion,25,0,0,5,12
Excalibur,0,12,0,5,3
MONSTERS
Omega-Demon-Lord,20,10,3,7
ENDFILE